     ###            ############################ ##########      ############   
     #·#            #··························# #········########····##····####
     #·#            #·#####################··### ###············##····##·······#
    ##·##############·#####################··####  #·##########·###·##########·#
    #···········································# ##·##       #·# #·#       ##·#
    ##·##############·###############··#####·#### #···#       #·# #·#       █··#
     #·#            #·#########     #··#   #·#    #···# #######·###·#########·##
     #·#           ##·##······##    #··#   #·#### ##### #··················##·# 
     #·#           #···········#    #··#   #····#       #··················##·# 
     #·#           #··########·#    ####   #··###       #··················##·##
     #·#     #######··########·#       #####··######    #··················##··#
   ###·#     #··············##·#       #···········#    #######·#·###########·##
   #···#     ########·########·#       #···········#     ######·#·#######   #·# 
   #·#·#            #·#      #·#       #···········#     #··············### #·# 
 ###·#·#            #·#      #·##      #···········#     #·####·#######·#·###·# 
 #·····##############·#      #··#      #···········#     #·#  #·#     #·#·····# 
 #····················#####  ####      #####··######   ###·####·#     #·#·###·# 
 #·····######·············#                #··##########······#·#     #·### #·# 
 ###·###    #·············#                #··········##······#·#######·#####·##
   #·#      #·············#       ##########··#################·##·········##··#
   #·#      #######·#######       #·················#         #·##·········##··#
   #·#            #·#             #·····####·######·#         #·##·········##·##
   #·#           ##·#########     #·····#  ###    #·#         #·##·········##·# 
   #·#############··········#     #·#####        ##·##        #·#######·#####·# 
   #························#  ####·#####        #···# ########·#     #·#   #·# 
   ###############··········#  #········#        #···# #········#   ###·#####·# 
                 ############  #········#        ##·## #········#   #·········# 
                               #········#       ###·####···@····#   ########### 
                               #········#       #···············#               
                               ##########       #################               
